########E#
#        #
# ###### #
# #    # #
# # ## # #
# # #  # #
#   ##   #
####### ##
#S       #
##########