#######
#     #
# ### #
#S# #E#
# ### #
#     #
#######