##########
#S       #
# ###### #
#       E#
##########