#######
#S#   #
# ###E#
#     #
#######
