#######
#S#   #
# ### #
#E#   #
#######
