#########
#S      #
##### ###
#E# # # #
### # # #
#########
