#########
#S      #
#       #
#       #
#      E#
#########
