#######
#S # E#
# # # #
#     #
#######
