#########
#S      #
# #######
#       #
####### #
#E      #
#########
