#########
#S# # #E#
### ### #
#       #
#########
