#######
#S    #
# ### #
#   #E#
#######
